{
  "background": [
      ["t", "t", "t", "t", "t", "t", "t", "t", "t", "t"],
      ["t", "t", "t", "t", "t", "t", "t", "t", "t", "t"],
      ["t", "t", "t", "t", "t", "t", "t", "t", "t", "t"],
      ["t", "t", "t", "t", "t", "t", "t", "t", "t", "t"],
      ["t", "t", "t", "t", "t", "t", "t", "t", "t", "t"],
      ["t", "t", "t", "t", "t", "t", "t", "t", "t", "t"],
      ["t", "t", "t", "t", "t", "t", "t", "t", "t", "t"],
      ["t", "t", "t", "t", "t", "t", "t", "t", "t", "t"],
      ["t", "t", "t", "t", "t", "t", "t", "t", "t", "t"]
  ],
  "foreground": [
      [" ", "w", "w", "w", "w", " ", " ", " ", " ", " "],
      [" ", " ", " ", " ", "w", " ", " ", " ", " ", " "],
      [" ", " ", " ", " ", "w", " ", " ", " ", " ", " "],
      [" ", " ", " ", " ", "w", " ", " ", " ", " ", " "],
      [" ", " ", " ", " ", " ", "T", " ", " ", " ", " "],
      [" ", " ", " ", " ", "w", " ", " ", " ", " ", " "],
      [" ", " ", " ", " ", "w", " ", " ", " ", " ", " "],
      [" ", " ", " ", " ", "w", " ", " ", " ", " ", " "],
      [" ", " ", " ", " ", "w", " ", " ", " ", " ", " "]
  ]
}
