{
  "background": [
      ["w", "w", "w", "w", "w", "w", "w", "w", "w", "w"],
      ["t", "t", "t", "t", "t", "t", "t", "t", "t", "t"],
      ["t", "t", "t", "t", "t", "t", "t", "t", "t", "t"],
      ["t", "t", "t", "t", "t", "t", "t", "t", "t", "t"],
      ["t", "t", "t", "t", "t", "w", "t", "t", "t", "t"],
      ["t", "t", "t", "t", "t", "t", "t", "t", "t", "t"],
      ["t", "t", "t", "t", "t", "t", "t", "t", "t", "t"],
      ["t", "t", "t", "t", "t", "t", "t", "t", "t", "t"],
      ["t", "t", "t", "t", "t", "t", "t", "t", "t", "t"]
  ]
}
