{
  "level": ["0", "1", "2"],
  "0": [
      ["t", "t", "t", "t", "t", "t", "t", "t", "t", "t"],
      ["t", "t", "t", "a", "a", "a", "t", "t", "t", "t"],
      ["t", "t", "t", "t", "a", "a", "t", "t", "t", "t"],
      ["t", "t", "t", "t", "a", "a", "t", "t", "t", "t"],
      ["t", "t", "t", "t", "a", "a", "t", "t", "t", "t"],
      ["t", "t", "t", "t", "a", "a", "t", "t", "t", "t"],
      ["t", "t", "t", "t", "a", "a", "t", "t", "t", "t"],
      ["t", "t", "t", "t", "a", "a", "t", "t", "t", "t"],
      ["t", "t", "t", "t", "t", "t", "t", "t", "t", "t"]
  ],
  "1": [
      ["t", "t", "t", "t", "t", "t", "t", "t", "t", "t"],
      ["t", "t", "t", "a", "a", "a", "a", "t", "t", "t"],
      ["t", "t", "t", "t", "t", "a", "a", "t", "t", "t"],
      ["t", "t", "t", "t", "t", "a", "a", "t", "t", "t"],
      ["t", "t", "t", "a", "a", "a", "a", "t", "t", "t"],
      ["t", "t", "t", "a", "a", "t", "t", "t", "t", "t"],
      ["t", "t", "t", "a", "a", "t", "t", "t", "t", "t"],
      ["t", "t", "t", "a", "a", "a", "a", "t", "t", "t"],
      ["t", "t", "t", "t", "t", "t", "t", "t", "t", "t"]
  ],
  "2": [
      ["t", "t", "t", "t", "t", "t", "t", "t", "t", "t"],
      ["t", "t", "t", "a", "a", "a", "a", "t", "t", "t"],
      ["t", "t", "t", "t", "t", "a", "a", "t", "t", "t"],
      ["t", "t", "t", "t", "t", "a", "a", "t", "t", "t"],
      ["t", "t", "t", "a", "a", "a", "a", "t", "t", "t"],
      ["t", "t", "t", "t", "t", "a", "a", "t", "t", "t"],
      ["t", "t", "t", "t", "t", "a", "a", "t", "t", "t"],
      ["t", "t", "t", "a", "a", "a", "a", "t", "t", "t"],
      ["t", "t", "t", "t", "t", "t", "t", "t", "t", "t"]
  ]
}
